+-+-+-+-+-+-+-+
| |     | |   |
+ + +-+ + +-+ +
|   | | | | | |
+-+ + + + + + +
|     | |   | |
+-+-+ + + +-+ +
|       |     |
+-+-+-+ +-+-+ +
|     | |   | |
+ + + + +-+ + +
| | | | | | | |
+-+-+ + + + + +
|             |
+-+-+-+-+-+-+-+
