+-+-+-+-+-+-+-+
|   | | |   | |
+ + + + +-+ + +
| | |   |     |
+ + +-+ +-+-+ +
| |   |   | | |
+-+ +-+ +-+ + +
|   | | | |   |
+-+ + + + + +-+
| | |   | |   |
+ + + +-+ +-+ +
| | |     | | |
+ + +-+-+ + + +
|             |
+-+-+-+-+-+-+-+
